13
31
###############################
#p    s** *  1 * 2 *  * * *   #
# # # #*# # #*#*# # # #*#*#*# #
#  x*   b ***  *  1   * 2 * * #
# # # # # #*# # #*#*# # # # #*#
#f   f     x **  *  *   1     #
# # # # # # # # # #*# #*# # # #
#*  *      *  *      *        #
# # # # #*# # # #*#*# # # # # #
#*    **  *       *           #
# #*# # # # # # #*# # # # # # #
#           *   *  *          #
###############################
                                   

